R 1280 720
NO ./texture/path_to_the_north_texture1.xpm
SO ./texture/path_to_the_south_texture1.xpm
WE ./texture/path_to_the_west_texture1.xpm
EA ./texture/path_to_the_east_texture1.xpm
S ./texture/path_to_the_sprite_texture1.xpm
F 101,67,33
C 172,253,255

111111111111
122220002221
122220002221
122220102221
122220002221
122220002221
100000N00001
111111111111