R 1280 720
NO ./texture/path_to_the_north_texture1.xpm
SO ./texture/path_to_the_south_texture1.xpm
WE ./texture/path_to_the_west_texture1.xpm
EA ./texture/path_to_the_east_texture1.xpm
S ./texture/path_to_the_sprite_texture1.xpm
F 101,67,33
C 172,253,255

        1111111111111111111111111
        1000000000110000000000001
        1011000001110000000000001
        1001000000000000000000001
111111111011000001110000000000001
100000000011000001110111111111111
11110111111111011100000010001
11110111111111011101010010001
1100020W110101011100000010001
10200200000200001100000010001
10000000200000001101010010001
1100000111010101111101111000111
11110111 1110101 101111010001
11111111 1111111 111111111111